00000100000100010000100
00000100100101000000101
00000001010000010000101
00000100100101000000101
00000100000100010000001