00000100000000010000
01000100100000010000
01000001110000010000
01000100100000010000
01000100000000010000