000001000000100000000
000001000000100100000
000000000000100100000
000001000000100100000
000001000000000111111
000001000000000111111
000001000000000111111