00000100000100010000100000000000000100001
00000100000101000000100100000110000100001
00000000000000010000100100000110000100001
00000100000101000000100100000000000000011
0000010000010001000000011111110000100001
00000100000100010000000111111100000100001
00000100000100010000000111111100000100000