000001000000100000000000000100001
000001000000100100000110000100001
000000000000100100000110000100001
000001000000100100000000000000011
000001000000000111111100001000010
000001000000000111111100000100001
000001000000000111111100000100000