0000010000010001000010000000100000100010000001
0000010010010100000010100000100000100010000001
0000000101000001000010100000100000100010000001
0000010010010100000010100000100000100010000001
0000010000010001000000100000100000100010000001
0000010000010001000000100000100000100010000001
0000010000010001000000100000100000100010000001
0000010000010001000000100000100000100010000001
0000010000010001000000100000100000100010000001
0000010000010001000000100000100000100010000001
0000010000010001000000100000100000100010000001
0000010000010001000000100000100000100010000001
0000010000010001000000100000100000100010000001
0000010000010001000000100000100000100010000001
0000010000010001000000100000100000100010000001
0000010000010001000000100000100000100010000001
0000010000010001000000100000100000100010000001
0000010000010001000000100000100000100010000001
0000010000010001000000100000100000100010000001