000001000000100000000000000100001
000001000000100100000110000100001
000000000000100100000110000100001
000001000000100100000000000000011
00000100000000011111110000100001
000001000000000111111100000100001
000001000000000111111100000100000