000001000000100000000111111100011
000001000000100000000111111100011
000000000000000000000111111100011
000000000000100000000000000000011
000001000000100111111100000000011
000001000000100111111100000100000
000001000000100111111100000100000