0000010000001000000001
0000010000001000000001
0000000000000000000001
0000000000001000000000
0000010000001001111111
0000010000001001111111
0000010000001001111111