0000011111111111111111
0000011111111111111111
0000000000000000000001
0000000000001000000000
0000010000001001111111
0000010000001001111111
0000010000001001111111